████████████████████
H                 █
█  ████████████████
█  █             █
█  █  █████████  █
█  █  █     █    █
█  █  █ $ X      D
█  █  █     █    █
█  █  █████████  █
█                █
██████████████████

